alternative_medium:medium	medium:id
alternative_medium:alternative_release	alternative_release:id
alternative_medium_track:alternative_medium	alternative_medium:id
alternative_medium_track:track	track:id
alternative_medium_track:alternative_track	alternative_track:id
alternative_release:release	release:id
alternative_release:artist_credit	artist_credit:id
alternative_release:type	alternative_release_type:id
alternative_release:language	language:id
alternative_release:script	script:id
alternative_release_type:parent	alternative_release_type:id
alternative_track:artist_credit	artist_credit:id
annotation:editor	editor:id
application:owner	editor:id
area:type	area_type:id
area_alias:area	area:id
area_alias:type	area_alias_type:id
area_alias_type:parent	area_alias_type:id
area_annotation:area	area:id
area_annotation:annotation	annotation:id
area_gid_redirect:new_id	area:id
area_tag:area	area:id
area_tag:tag	tag:id
area_tag_raw:area	area:id
area_tag_raw:editor	editor:id
area_tag_raw:tag	tag:id
area_type:parent	area_type:id
artist:type	artist_type:id
artist:area	area:id
artist:gender	gender:id
artist:begin_area	area:id
artist:end_area	area:id
artist_alias:artist	artist:id
artist_alias:type	artist_alias_type:id
artist_alias_type:parent	artist_alias_type:id
artist_annotation:artist	artist:id
artist_annotation:annotation	annotation:id
artist_credit_name:artist_credit	artist_credit:id
artist_credit_name:artist	artist:id
artist_gid_redirect:new_id	artist:id
artist_ipi:artist	artist:id
artist_isni:artist	artist:id
artist_meta:id	artist:id
artist_rating_raw:artist	artist:id
artist_rating_raw:editor	editor:id
artist_tag:artist	artist:id
artist_tag:tag	tag:id
artist_tag_raw:artist	artist:id
artist_tag_raw:editor	editor:id
artist_tag_raw:tag	tag:id
artist_type:parent	artist_type:id
autoeditor_election:candidate	editor:id
autoeditor_election:proposer	editor:id
autoeditor_election:seconder_1	editor:id
autoeditor_election:seconder_2	editor:id
autoeditor_election_vote:autoeditor_election	autoeditor_election:id
autoeditor_election_vote:voter	editor:id
cdtoc_raw:release	release_raw:id
country_area:area	area:id
edit:editor	editor:id
edit:language	language:id
edit_area:edit	edit:id
edit_area:area	area:id
edit_artist:edit	edit:id
edit_artist:artist	artist:id
edit_data:edit	edit:id
edit_event:edit	edit:id
edit_event:event	event:id
edit_instrument:edit	edit:id
edit_instrument:instrument	instrument:id
edit_label:edit	edit:id
edit_label:label	label:id
edit_note:editor	editor:id
edit_note:edit	edit:id
edit_note_recipient:recipient	editor:id
edit_note_recipient:edit_note	edit_note:id
edit_place:edit	edit:id
edit_place:place	place:id
edit_recording:edit	edit:id
edit_recording:recording	recording:id
edit_release:edit	edit:id
edit_release:release	release:id
edit_release_group:edit	edit:id
edit_release_group:release_group	release_group:id
edit_series:edit	edit:id
edit_series:series	series:id
edit_url:edit	edit:id
edit_url:url	url:id
edit_work:edit	edit:id
edit_work:work	work:id
editor:gender	gender:id
editor:area	area:id
editor_collection:editor	editor:id
editor_collection:type	editor_collection_type:id
editor_collection_area:collection	editor_collection:id
editor_collection_area:area	area:id
editor_collection_artist:collection	editor_collection:id
editor_collection_artist:artist	artist:id
editor_collection_deleted_entity:collection	editor_collection:id
editor_collection_deleted_entity:gid	deleted_entity:gid
editor_collection_event:collection	editor_collection:id
editor_collection_event:event	event:id
editor_collection_instrument:collection	editor_collection:id
editor_collection_instrument:instrument	instrument:id
editor_collection_label:collection	editor_collection:id
editor_collection_label:label	label:id
editor_collection_place:collection	editor_collection:id
editor_collection_place:place	place:id
editor_collection_recording:collection	editor_collection:id
editor_collection_recording:recording	recording:id
editor_collection_release:collection	editor_collection:id
editor_collection_release:release	release:id
editor_collection_release_group:collection	editor_collection:id
editor_collection_release_group:release_group	release_group:id
editor_collection_series:collection	editor_collection:id
editor_collection_series:series	series:id
editor_collection_type:parent	editor_collection_type:id
editor_collection_work:collection	editor_collection:id
editor_collection_work:work	work:id
editor_language:editor	editor:id
editor_language:language	language:id
editor_oauth_token:editor	editor:id
editor_oauth_token:application	application:id
editor_preference:editor	editor:id
editor_subscribe_artist:editor	editor:id
editor_subscribe_artist:artist	artist:id
editor_subscribe_artist:last_edit_sent	edit:id
editor_subscribe_artist_deleted:editor	editor:id
editor_subscribe_artist_deleted:gid	deleted_entity:gid
editor_subscribe_artist_deleted:deleted_by	edit:id
editor_subscribe_collection:editor	editor:id
editor_subscribe_editor:editor	editor:id
editor_subscribe_editor:subscribed_editor	editor:id
editor_subscribe_label:editor	editor:id
editor_subscribe_label:label	label:id
editor_subscribe_label:last_edit_sent	edit:id
editor_subscribe_label_deleted:editor	editor:id
editor_subscribe_label_deleted:gid	deleted_entity:gid
editor_subscribe_label_deleted:deleted_by	edit:id
editor_subscribe_series:editor	editor:id
editor_subscribe_series:series	series:id
editor_subscribe_series:last_edit_sent	edit:id
editor_subscribe_series_deleted:editor	editor:id
editor_subscribe_series_deleted:gid	deleted_entity:gid
editor_subscribe_series_deleted:deleted_by	edit:id
editor_watch_artist:artist	artist:id
editor_watch_artist:editor	editor:id
editor_watch_preferences:editor	editor:id
editor_watch_release_group_type:editor	editor:id
editor_watch_release_group_type:release_group_type	release_group_primary_type:id
editor_watch_release_status:editor	editor:id
editor_watch_release_status:release_status	release_status:id
event:type	event_type:id
event_alias:event	event:id
event_alias:type	event_alias_type:id
event_alias_type:parent	event_alias_type:id
event_annotation:event	event:id
event_annotation:annotation	annotation:id
event_gid_redirect:new_id	event:id
event_meta:id	event:id
event_rating_raw:event	event:id
event_rating_raw:editor	editor:id
event_tag:event	event:id
event_tag:tag	tag:id
event_tag_raw:event	event:id
event_tag_raw:editor	editor:id
event_tag_raw:tag	tag:id
event_type:parent	event_type:id
gender:parent	gender:id
instrument:type	instrument_type:id
instrument_alias:instrument	instrument:id
instrument_alias:type	instrument_alias_type:id
instrument_alias_type:parent	instrument_alias_type:id
instrument_annotation:instrument	instrument:id
instrument_annotation:annotation	annotation:id
instrument_gid_redirect:new_id	instrument:id
instrument_tag:instrument	instrument:id
instrument_tag:tag	tag:id
instrument_tag_raw:instrument	instrument:id
instrument_tag_raw:editor	editor:id
instrument_tag_raw:tag	tag:id
instrument_type:parent	instrument_type:id
iso_3166_1:area	area:id
iso_3166_2:area	area:id
iso_3166_3:area	area:id
isrc:recording	recording:id
iswc:work	work:id
l_area_area:link	link:id
l_area_area:entity0	area:id
l_area_area:entity1	area:id
l_area_artist:link	link:id
l_area_artist:entity0	area:id
l_area_artist:entity1	artist:id
l_area_event:link	link:id
l_area_event:entity0	area:id
l_area_event:entity1	event:id
l_area_instrument:link	link:id
l_area_instrument:entity0	area:id
l_area_instrument:entity1	instrument:id
l_area_label:link	link:id
l_area_label:entity0	area:id
l_area_label:entity1	label:id
l_area_place:link	link:id
l_area_place:entity0	area:id
l_area_place:entity1	place:id
l_area_recording:link	link:id
l_area_recording:entity0	area:id
l_area_recording:entity1	recording:id
l_area_release:link	link:id
l_area_release:entity0	area:id
l_area_release:entity1	release:id
l_area_release_group:link	link:id
l_area_release_group:entity0	area:id
l_area_release_group:entity1	release_group:id
l_area_series:link	link:id
l_area_series:entity0	area:id
l_area_series:entity1	series:id
l_area_url:link	link:id
l_area_url:entity0	area:id
l_area_url:entity1	url:id
l_area_work:link	link:id
l_area_work:entity0	area:id
l_area_work:entity1	work:id
l_artist_artist:link	link:id
l_artist_artist:entity0	artist:id
l_artist_artist:entity1	artist:id
l_artist_event:link	link:id
l_artist_event:entity0	artist:id
l_artist_event:entity1	event:id
l_artist_instrument:link	link:id
l_artist_instrument:entity0	artist:id
l_artist_instrument:entity1	instrument:id
l_artist_label:link	link:id
l_artist_label:entity0	artist:id
l_artist_label:entity1	label:id
l_artist_place:link	link:id
l_artist_place:entity0	artist:id
l_artist_place:entity1	place:id
l_artist_recording:link	link:id
l_artist_recording:entity0	artist:id
l_artist_recording:entity1	recording:id
l_artist_release:link	link:id
l_artist_release:entity0	artist:id
l_artist_release:entity1	release:id
l_artist_release_group:link	link:id
l_artist_release_group:entity0	artist:id
l_artist_release_group:entity1	release_group:id
l_artist_series:link	link:id
l_artist_series:entity0	artist:id
l_artist_series:entity1	series:id
l_artist_url:link	link:id
l_artist_url:entity0	artist:id
l_artist_url:entity1	url:id
l_artist_work:link	link:id
l_artist_work:entity0	artist:id
l_artist_work:entity1	work:id
l_event_event:link	link:id
l_event_event:entity0	event:id
l_event_event:entity1	event:id
l_event_instrument:link	link:id
l_event_instrument:entity0	event:id
l_event_instrument:entity1	instrument:id
l_event_label:link	link:id
l_event_label:entity0	event:id
l_event_label:entity1	label:id
l_event_place:link	link:id
l_event_place:entity0	event:id
l_event_place:entity1	place:id
l_event_recording:link	link:id
l_event_recording:entity0	event:id
l_event_recording:entity1	recording:id
l_event_release:link	link:id
l_event_release:entity0	event:id
l_event_release:entity1	release:id
l_event_release_group:link	link:id
l_event_release_group:entity0	event:id
l_event_release_group:entity1	release_group:id
l_event_series:link	link:id
l_event_series:entity0	event:id
l_event_series:entity1	series:id
l_event_url:link	link:id
l_event_url:entity0	event:id
l_event_url:entity1	url:id
l_event_work:link	link:id
l_event_work:entity0	event:id
l_event_work:entity1	work:id
l_instrument_instrument:link	link:id
l_instrument_instrument:entity0	instrument:id
l_instrument_instrument:entity1	instrument:id
l_instrument_label:link	link:id
l_instrument_label:entity0	instrument:id
l_instrument_label:entity1	label:id
l_instrument_place:link	link:id
l_instrument_place:entity0	instrument:id
l_instrument_place:entity1	place:id
l_instrument_recording:link	link:id
l_instrument_recording:entity0	instrument:id
l_instrument_recording:entity1	recording:id
l_instrument_release:link	link:id
l_instrument_release:entity0	instrument:id
l_instrument_release:entity1	release:id
l_instrument_release_group:link	link:id
l_instrument_release_group:entity0	instrument:id
l_instrument_release_group:entity1	release_group:id
l_instrument_series:link	link:id
l_instrument_series:entity0	instrument:id
l_instrument_series:entity1	series:id
l_instrument_url:link	link:id
l_instrument_url:entity0	instrument:id
l_instrument_url:entity1	url:id
l_instrument_work:link	link:id
l_instrument_work:entity0	instrument:id
l_instrument_work:entity1	work:id
l_label_label:link	link:id
l_label_label:entity0	label:id
l_label_label:entity1	label:id
l_label_place:link	link:id
l_label_place:entity0	label:id
l_label_place:entity1	place:id
l_label_recording:link	link:id
l_label_recording:entity0	label:id
l_label_recording:entity1	recording:id
l_label_release:link	link:id
l_label_release:entity0	label:id
l_label_release:entity1	release:id
l_label_release_group:link	link:id
l_label_release_group:entity0	label:id
l_label_release_group:entity1	release_group:id
l_label_series:link	link:id
l_label_series:entity0	label:id
l_label_series:entity1	series:id
l_label_url:link	link:id
l_label_url:entity0	label:id
l_label_url:entity1	url:id
l_label_work:link	link:id
l_label_work:entity0	label:id
l_label_work:entity1	work:id
l_place_place:link	link:id
l_place_place:entity0	place:id
l_place_place:entity1	place:id
l_place_recording:link	link:id
l_place_recording:entity0	place:id
l_place_recording:entity1	recording:id
l_place_release:link	link:id
l_place_release:entity0	place:id
l_place_release:entity1	release:id
l_place_release_group:link	link:id
l_place_release_group:entity0	place:id
l_place_release_group:entity1	release_group:id
l_place_series:link	link:id
l_place_series:entity0	place:id
l_place_series:entity1	series:id
l_place_url:link	link:id
l_place_url:entity0	place:id
l_place_url:entity1	url:id
l_place_work:link	link:id
l_place_work:entity0	place:id
l_place_work:entity1	work:id
l_recording_recording:link	link:id
l_recording_recording:entity0	recording:id
l_recording_recording:entity1	recording:id
l_recording_release:link	link:id
l_recording_release:entity0	recording:id
l_recording_release:entity1	release:id
l_recording_release_group:link	link:id
l_recording_release_group:entity0	recording:id
l_recording_release_group:entity1	release_group:id
l_recording_series:link	link:id
l_recording_series:entity0	recording:id
l_recording_series:entity1	series:id
l_recording_url:link	link:id
l_recording_url:entity0	recording:id
l_recording_url:entity1	url:id
l_recording_work:link	link:id
l_recording_work:entity0	recording:id
l_recording_work:entity1	work:id
l_release_group_release_group:link	link:id
l_release_group_release_group:entity0	release_group:id
l_release_group_release_group:entity1	release_group:id
l_release_group_series:link	link:id
l_release_group_series:entity0	release_group:id
l_release_group_series:entity1	series:id
l_release_group_url:link	link:id
l_release_group_url:entity0	release_group:id
l_release_group_url:entity1	url:id
l_release_group_work:link	link:id
l_release_group_work:entity0	release_group:id
l_release_group_work:entity1	work:id
l_release_release:link	link:id
l_release_release:entity0	release:id
l_release_release:entity1	release:id
l_release_release_group:link	link:id
l_release_release_group:entity0	release:id
l_release_release_group:entity1	release_group:id
l_release_series:link	link:id
l_release_series:entity0	release:id
l_release_series:entity1	series:id
l_release_url:link	link:id
l_release_url:entity0	release:id
l_release_url:entity1	url:id
l_release_work:link	link:id
l_release_work:entity0	release:id
l_release_work:entity1	work:id
l_series_series:link	link:id
l_series_series:entity0	series:id
l_series_series:entity1	series:id
l_series_url:link	link:id
l_series_url:entity0	series:id
l_series_url:entity1	url:id
l_series_work:link	link:id
l_series_work:entity0	series:id
l_series_work:entity1	work:id
l_url_url:link	link:id
l_url_url:entity0	url:id
l_url_url:entity1	url:id
l_url_work:link	link:id
l_url_work:entity0	url:id
l_url_work:entity1	work:id
l_work_work:link	link:id
l_work_work:entity0	work:id
l_work_work:entity1	work:id
label:type	label_type:id
label:area	area:id
label_alias:label	label:id
label_alias:type	label_alias_type:id
label_alias_type:parent	label_alias_type:id
label_annotation:label	label:id
label_annotation:annotation	annotation:id
label_gid_redirect:new_id	label:id
label_ipi:label	label:id
label_isni:label	label:id
label_meta:id	label:id
label_rating_raw:label	label:id
label_rating_raw:editor	editor:id
label_tag:label	label:id
label_tag:tag	tag:id
label_tag_raw:label	label:id
label_tag_raw:editor	editor:id
label_tag_raw:tag	tag:id
label_type:parent	label_type:id
link:link_type	link_type:id
link_attribute:link	link:id
link_attribute:attribute_type	link_attribute_type:id
link_attribute_credit:link	link:id
link_attribute_credit:attribute_type	link_creditable_attribute_type:attribute_type
link_attribute_text_value:link	link:id
link_attribute_text_value:attribute_type	link_text_attribute_type:attribute_type
link_attribute_type:parent	link_attribute_type:id
link_attribute_type:root	link_attribute_type:id
link_creditable_attribute_type:attribute_type	link_attribute_type:id
link_text_attribute_type:attribute_type	link_attribute_type:id
link_type:parent	link_type:id
link_type_attribute_type:link_type	link_type:id
link_type_attribute_type:attribute_type	link_attribute_type:id
medium:release	release:id
medium:format	medium_format:id
medium_cdtoc:medium	medium:id
medium_cdtoc:cdtoc	cdtoc:id
medium_format:parent	medium_format:id
medium_index:medium	medium:id
orderable_link_type:link_type	link_type:id
place:type	place_type:id
place:area	area:id
place_alias:place	place:id
place_alias:type	place_alias_type:id
place_alias_type:parent	place_alias_type:id
place_annotation:place	place:id
place_annotation:annotation	annotation:id
place_gid_redirect:new_id	place:id
place_tag:place	place:id
place_tag:tag	tag:id
place_tag_raw:place	place:id
place_tag_raw:editor	editor:id
place_tag_raw:tag	tag:id
place_type:parent	place_type:id
recording:artist_credit	artist_credit:id
recording_alias:recording	recording:id
recording_alias:type	recording_alias_type:id
recording_alias_type:parent	recording_alias_type:id
recording_annotation:recording	recording:id
recording_annotation:annotation	annotation:id
recording_gid_redirect:new_id	recording:id
recording_meta:id	recording:id
recording_rating_raw:recording	recording:id
recording_rating_raw:editor	editor:id
recording_tag:recording	recording:id
recording_tag:tag	tag:id
recording_tag_raw:recording	recording:id
recording_tag_raw:editor	editor:id
recording_tag_raw:tag	tag:id
release:artist_credit	artist_credit:id
release:release_group	release_group:id
release:status	release_status:id
release:packaging	release_packaging:id
release:language	language:id
release:script	script:id
release_alias:release	release:id
release_alias:type	release_alias_type:id
release_alias_type:parent	release_alias_type:id
release_annotation:release	release:id
release_annotation:annotation	annotation:id
release_country:release	release:id
release_country:country	country_area:area
release_coverart:id	release:id
release_gid_redirect:new_id	release:id
release_group:artist_credit	artist_credit:id
release_group:type	release_group_primary_type:id
release_group_alias:release_group	release_group:id
release_group_alias:type	release_group_alias_type:id
release_group_alias_type:parent	release_group_alias_type:id
release_group_annotation:release_group	release_group:id
release_group_annotation:annotation	annotation:id
release_group_gid_redirect:new_id	release_group:id
release_group_meta:id	release_group:id
release_group_primary_type:parent	release_group_primary_type:id
release_group_rating_raw:release_group	release_group:id
release_group_rating_raw:editor	editor:id
release_group_secondary_type:parent	release_group_secondary_type:id
release_group_secondary_type_join:release_group	release_group:id
release_group_secondary_type_join:secondary_type	release_group_secondary_type:id
release_group_tag:release_group	release_group:id
release_group_tag:tag	tag:id
release_group_tag_raw:release_group	release_group:id
release_group_tag_raw:editor	editor:id
release_group_tag_raw:tag	tag:id
release_label:release	release:id
release_label:label	label:id
release_meta:id	release:id
release_packaging:parent	release_packaging:id
release_status:parent	release_status:id
release_tag:release	release:id
release_tag:tag	tag:id
release_tag_raw:release	release:id
release_tag_raw:editor	editor:id
release_tag_raw:tag	tag:id
release_unknown_country:release	release:id
series:type	series_type:id
series:ordering_attribute	link_text_attribute_type:attribute_type
series:ordering_type	series_ordering_type:id
series_alias:series	series:id
series_alias:type	series_alias_type:id
series_alias_type:parent	series_alias_type:id
series_annotation:series	series:id
series_annotation:annotation	annotation:id
series_gid_redirect:new_id	series:id
series_ordering_type:parent	series_ordering_type:id
series_tag:series	series:id
series_tag:tag	tag:id
series_tag_raw:series	series:id
series_tag_raw:editor	editor:id
series_tag_raw:tag	tag:id
series_type:parent	series_type:id
tag_relation:tag1	tag:id
tag_relation:tag2	tag:id
track:recording	recording:id
track:medium	medium:id
track:artist_credit	artist_credit:id
track_gid_redirect:new_id	track:id
track_raw:release	release_raw:id
url_gid_redirect:new_id	url:id
vote:editor	editor:id
vote:edit	edit:id
work:type	work_type:id
work:language	language:id
work_alias:work	work:id
work_alias:type	work_alias_type:id
work_alias_type:parent	work_alias_type:id
work_annotation:work	work:id
work_annotation:annotation	annotation:id
work_attribute:work	work:id
work_attribute:work_attribute_type	work_attribute_type:id
work_attribute:work_attribute_type_allowed_value	work_attribute_type_allowed_value:id
work_attribute_type:parent	work_attribute_type:id
work_attribute_type_allowed_value:work_attribute_type	work_attribute_type:id
work_attribute_type_allowed_value:parent	work_attribute_type_allowed_value:id
work_gid_redirect:new_id	work:id
work_meta:id	work:id
work_rating_raw:work	work:id
work_rating_raw:editor	editor:id
work_tag:work	work:id
work_tag:tag	tag:id
work_tag_raw:work	work:id
work_tag_raw:editor	editor:id
work_tag_raw:tag	tag:id
work_type:parent	work_type:id
cover_art_archive.art_type:parent	cover_art_archive.art_type:id
cover_art_archive.cover_art:release	release:id
cover_art_archive.cover_art:mime_type	cover_art_archive.image_type:mime_type
cover_art_archive.cover_art_type:id	cover_art_archive.cover_art:id
cover_art_archive.cover_art_type:type_id	cover_art_archive.art_type:id
cover_art_archive.release_group_cover_art:release_group	release_group:id
cover_art_archive.release_group_cover_art:release	release:id
documentation.l_area_area_example:id	l_area_area:id
documentation.l_area_artist_example:id	l_area_artist:id
documentation.l_area_event_example:id	l_area_event:id
documentation.l_area_instrument_example:id	l_area_instrument:id
documentation.l_area_label_example:id	l_area_label:id
documentation.l_area_place_example:id	l_area_place:id
documentation.l_area_recording_example:id	l_area_recording:id
documentation.l_area_release_example:id	l_area_release:id
documentation.l_area_release_group_example:id	l_area_release_group:id
documentation.l_area_series_example:id	l_area_series:id
documentation.l_area_url_example:id	l_area_url:id
documentation.l_area_work_example:id	l_area_work:id
documentation.l_artist_artist_example:id	l_artist_artist:id
documentation.l_artist_event_example:id	l_artist_event:id
documentation.l_artist_instrument_example:id	l_artist_instrument:id
documentation.l_artist_label_example:id	l_artist_label:id
documentation.l_artist_place_example:id	l_artist_place:id
documentation.l_artist_recording_example:id	l_artist_recording:id
documentation.l_artist_release_example:id	l_artist_release:id
documentation.l_artist_release_group_example:id	l_artist_release_group:id
documentation.l_artist_series_example:id	l_artist_series:id
documentation.l_artist_url_example:id	l_artist_url:id
documentation.l_artist_work_example:id	l_artist_work:id
documentation.l_event_event_example:id	l_event_event:id
documentation.l_event_instrument_example:id	l_event_instrument:id
documentation.l_event_label_example:id	l_event_label:id
documentation.l_event_place_example:id	l_event_place:id
documentation.l_event_recording_example:id	l_event_recording:id
documentation.l_event_release_example:id	l_event_release:id
documentation.l_event_release_group_example:id	l_event_release_group:id
documentation.l_event_series_example:id	l_event_series:id
documentation.l_event_url_example:id	l_event_url:id
documentation.l_event_work_example:id	l_event_work:id
documentation.l_instrument_instrument_example:id	l_instrument_instrument:id
documentation.l_instrument_label_example:id	l_instrument_label:id
documentation.l_instrument_place_example:id	l_instrument_place:id
documentation.l_instrument_recording_example:id	l_instrument_recording:id
documentation.l_instrument_release_example:id	l_instrument_release:id
documentation.l_instrument_release_group_example:id	l_instrument_release_group:id
documentation.l_instrument_series_example:id	l_instrument_series:id
documentation.l_instrument_url_example:id	l_instrument_url:id
documentation.l_instrument_work_example:id	l_instrument_work:id
documentation.l_label_label_example:id	l_label_label:id
documentation.l_label_place_example:id	l_label_place:id
documentation.l_label_recording_example:id	l_label_recording:id
documentation.l_label_release_example:id	l_label_release:id
documentation.l_label_release_group_example:id	l_label_release_group:id
documentation.l_label_series_example:id	l_label_series:id
documentation.l_label_url_example:id	l_label_url:id
documentation.l_label_work_example:id	l_label_work:id
documentation.l_place_place_example:id	l_place_place:id
documentation.l_place_recording_example:id	l_place_recording:id
documentation.l_place_release_example:id	l_place_release:id
documentation.l_place_release_group_example:id	l_place_release_group:id
documentation.l_place_series_example:id	l_place_series:id
documentation.l_place_url_example:id	l_place_url:id
documentation.l_place_work_example:id	l_place_work:id
documentation.l_recording_recording_example:id	l_recording_recording:id
documentation.l_recording_release_example:id	l_recording_release:id
documentation.l_recording_release_group_example:id	l_recording_release_group:id
documentation.l_recording_series_example:id	l_recording_series:id
documentation.l_recording_url_example:id	l_recording_url:id
documentation.l_recording_work_example:id	l_recording_work:id
documentation.l_release_group_release_group_example:id	l_release_group_release_group:id
documentation.l_release_group_series_example:id	l_release_group_series:id
documentation.l_release_group_url_example:id	l_release_group_url:id
documentation.l_release_group_work_example:id	l_release_group_work:id
documentation.l_release_release_example:id	l_release_release:id
documentation.l_release_release_group_example:id	l_release_release_group:id
documentation.l_release_series_example:id	l_release_series:id
documentation.l_release_url_example:id	l_release_url:id
documentation.l_release_work_example:id	l_release_work:id
documentation.l_series_series_example:id	l_series_series:id
documentation.l_series_url_example:id	l_series_url:id
documentation.l_series_work_example:id	l_series_work:id
documentation.l_url_url_example:id	l_url_url:id
documentation.l_url_work_example:id	l_url_work:id
documentation.l_work_work_example:id	l_work_work:id
documentation.link_type_documentation:id	link_type:id
sitemaps.artist_lastmod:id	artist:id
sitemaps.label_lastmod:id	label:id
sitemaps.place_lastmod:id	place:id
sitemaps.recording_lastmod:id	recording:id
sitemaps.release_group_lastmod:id	release_group:id
sitemaps.release_lastmod:id	release:id
sitemaps.work_lastmod:id	work:id
